111111111111111
111P0001C000C11
1001110000C0001
1001110000C0001
1001110000C0001
1001110000C0001
1001110000C0001
1001110000C0001
1001110000C0001
100C00C0C0000E1
111111111111111